11111111111111111111
11111111111111111111
11301000011000000011
11001000011000000011
11001000011000040011
11001110011000000011
11000000011100000011
11021110000000000011
11000000011111000011
11111111111111111111
11111111111111111111